106,23,23,23,23,23,23,23,23,23,23,23,23,23,57,51,51,51,51,51,51,51,51,51,51,51,51,51,67,23,23,23,23,23,23,23,23,23,23,23,23,23,23,23,23,23,23,23,23,23
57,51,51,51,51,51,51,51,67,23,23,23,23,23,50,2,1,1,1,1,1,1,1,1,1,1,112,2,50,23,23,23,23,23,23,23,23,23,23,23,23,23,23,23,23,23,23,23,23,23
50,2,2,3,1,1,1,2,50,23,23,23,23,23,50,2,1,1,1,1,1,1,1,1,1,1,1,2,50,23,23,23,23,23,23,23,23,23,23,23,23,23,23,23,23,23,23,23,23,23
50,1,1,1,2,3,1,1,61,51,51,51,51,51,60,1,1,102,70,70,70,70,70,70,70,103,1,1,61,51,51,51,51,51,51,51,51,51,51,51,51,51,51,51,67,23,23,23,23,23
50,1,2,3,2,3,1,1,2,2,2,2,2,2,2,2,2,73,106,106,106,106,106,106,106,71,1,112,1,1,1,1,1,1,1,1,1,1,1,1,1,1,1,1,50,23,23,23,23,23
50,1,1,2,3,1,1,1,1,1,1,1,1,1,1,1,1,73,106,106,106,106,106,106,106,71,1,1,2,2,2,2,2,2,2,2,2,2,2,2,2,2,2,1,50,23,23,23,23,23
50,2,3,1,1,1,1,1,57,51,51,51,51,51,67,1,1,73,106,106,96,72,97,106,106,71,1,1,57,51,51,51,51,51,51,51,51,51,51,51,51,67,2,1,50,23,23,23,23,23
50,1,1,1,1,2,3,1,50,23,23,23,23,23,50,2,3,73,106,106,71,228,73,106,106,71,1,1,50,23,23,23,23,23,23,23,23,23,23,23,23,50,2,1,50,23,23,23,23,23
50,1,209,3,1,2,3,1,50,23,23,23,23,23,50,2,3,73,106,106,101,70,100,106,106,71,1,1,50,23,23,23,23,23,23,23,23,23,23,23,23,50,2,1,50,23,23,23,57,65
50,1,219,226,2,3,1,1,50,23,23,23,23,23,50,112,1,73,106,106,106,106,106,106,106,71,1,1,50,23,23,23,23,23,23,23,23,23,23,23,23,50,2,1,50,23,23,23,50,228
50,1,1,1,1,1,112,1,50,23,23,23,23,23,50,1,1,105,72,72,72,72,72,72,72,104,1,1,50,23,23,23,23,23,23,23,23,23,23,23,23,50,2,1,50,23,23,23,61,65
50,1,1,1,1,1,1,1,50,23,23,23,23,23,50,1,112,1,1,1,1,1,1,4,5,1,1,1,50,23,23,23,23,23,23,23,23,23,23,23,23,50,2,1,50,23,23,23,23,23
61,51,51,67,2,2,57,51,60,23,23,23,23,23,50,1,1,1,1,1,1,1,2,1,1,1,1,1,50,23,23,23,23,23,23,23,23,23,23,23,23,50,2,1,50,23,23,23,23,23
106,23,23,50,2,2,50,23,23,23,23,23,23,23,61,51,51,51,51,51,51,67,2,2,57,51,51,51,60,23,23,23,23,23,23,57,51,51,51,51,51,60,2,2,61,51,51,51,67,23
106,23,23,50,2,2,50,23,23,23,23,23,23,23,23,23,23,23,23,23,23,50,2,2,50,23,23,23,23,23,23,23,23,23,23,50,115,2,2,2,2,2,2,2,2,2,2,115,50,23
106,23,23,50,2,2,50,23,23,57,51,51,51,51,51,51,67,23,23,23,23,50,2,2,50,23,23,23,23,23,23,23,23,23,23,50,2,2,2,2,2,2,2,2,2,2,2,2,50,23
106,23,23,50,2,2,50,23,23,50,224,2,203,1,187,225,50,23,23,23,23,50,2,2,50,23,23,23,23,23,23,23,23,23,23,50,2,2,2,2,4,4,4,5,2,4,5,2,50,23
106,23,23,50,2,2,50,23,23,50,2,2,213,1,197,228,50,23,23,23,23,50,2,2,61,51,51,51,51,51,51,51,51,51,51,60,2,2,2,4,5,2,2,2,4,5,2,2,50,23
106,23,23,50,2,2,50,23,23,50,168,168,168,168,168,168,50,23,23,23,23,50,2,2,2,2,2,2,2,2,2,2,2,2,2,2,2,2,4,112,2,2,2,2,2,2,2,2,50,23
106,23,23,50,2,2,50,23,23,50,178,178,178,178,178,178,50,23,23,23,23,50,2,2,2,2,2,2,2,2,2,2,2,2,2,2,2,2,2,2,2,2,2,4,5,185,2,2,50,23
106,23,23,50,2,2,50,23,23,61,51,67,144,145,57,51,60,23,23,23,23,50,2,2,57,51,51,51,51,51,51,51,51,51,51,67,2,2,2,2,2,2,2,4,5,195,185,2,50,23
106,23,23,50,2,2,61,51,51,51,51,60,154,155,61,51,51,51,51,51,51,60,2,2,61,51,51,67,23,23,23,23,23,23,23,50,2,2,2,2,2,2,4,5,2,226,195,2,50,23
106,23,23,50,2,2,2,2,2,2,2,2,2,2,2,2,2,2,2,2,2,2,2,2,2,2,2,50,23,23,23,23,23,23,23,50,2,2,4,5,5,4,5,2,2,2,2,2,50,23
106,23,23,50,2,4,5,2,2,2,2,2,2,2,2,2,2,2,2,2,2,2,2,2,2,2,2,50,23,23,23,23,23,23,23,50,2,2,2,2,2,2,2,2,2,2,2,2,50,23
106,23,23,50,112,2,2,57,51,51,51,51,51,51,51,51,51,67,2,115,4,1,4,2,2,4,2,50,23,23,23,23,23,23,23,61,51,51,51,51,67,112,2,57,51,51,51,51,60,23
106,23,23,50,2,2,2,61,67,23,23,23,23,23,23,23,23,50,2,115,2,2,4,2,2,4,2,50,23,23,23,23,23,23,23,23,23,23,23,23,50,2,2,50,23,23,23,23,23,23
106,23,23,50,2,2,2,2,61,67,23,23,23,23,23,23,23,50,2,2,2,2,1,2,2,1,2,50,23,23,23,23,23,23,23,23,23,23,23,23,50,2,2,50,23,23,23,23,23,23
106,23,23,61,67,2,209,225,2,61,67,23,23,23,23,23,23,50,2,4,4,4,112,4,4,4,2,61,51,51,51,51,51,51,51,51,51,51,51,51,60,2,2,50,23,23,23,23,23,23
106,51,51,51,52,65,219,2,4,5,61,67,23,23,23,23,23,50,2,4,2,2,4,2,2,2,2,2,2,2,2,2,2,2,2,2,2,2,2,2,2,2,2,50,23,23,23,23,23,23
106,2,2,2,2,2,2,2,2,2,2,61,51,51,51,51,51,60,2,4,2,2,4,2,2,2,2,2,2,2,2,2,2,2,4,5,2,2,2,2,2,2,2,50,23,23,23,23,23,23
106,2,2,2,2,2,2,2,2,2,112,2,2,4,5,2,2,2,2,2,2,2,4,4,2,2,200,57,51,51,51,51,51,51,51,51,51,51,51,51,51,51,51,60,23,23,23,23,23,23
106,51,51,51,51,51,51,51,67,2,2,2,2,2,2,2,2,2,2,2,2,2,2,2,2,2,210,50,23,23,23,23,23,23,23,23,23,23,23,23,23,23,23,23,23,23,23,23,23,23
106,23,23,23,23,23,23,23,61,51,51,51,51,51,51,51,51,51,51,51,51,67,2,2,57,51,51,60,23,23,23,23,23,23,23,23,23,23,23,23,23,23,23,23,23,23,23,23,23,23
106,23,23,23,23,23,23,23,23,23,23,23,23,23,23,23,23,23,23,23,23,50,2,2,50,23,23,23,23,23,23,23,23,23,23,23,23,23,23,23,23,23,23,23,23,23,23,23,23,23
106,23,23,23,23,23,23,23,23,23,23,23,23,23,23,23,23,23,23,23,23,50,2,2,50,23,23,23,23,23,23,23,23,23,23,23,23,23,23,23,23,23,23,23,23,23,23,23,23,23
106,23,23,23,23,23,23,23,23,23,23,23,23,23,23,23,23,23,23,23,23,50,2,2,50,23,23,23,23,23,23,23,23,23,23,23,23,23,23,23,23,23,23,23,23,23,23,23,23,23
106,23,23,23,23,23,23,23,23,23,23,23,23,23,57,51,51,51,51,51,51,60,2,2,61,51,51,51,51,51,51,51,67,23,23,23,23,23,23,23,23,23,23,23,23,23,23,23,23,23
106,23,23,23,23,23,23,23,23,23,23,23,23,23,50,2,2,2,2,2,2,2,2,2,2,2,2,4,5,2,209,118,50,23,23,23,23,23,23,23,23,23,23,23,23,23,23,23,23,23
106,23,23,23,23,23,23,23,23,23,23,23,23,23,50,2,112,5,2,2,2,2,4,5,2,2,2,2,2,2,219,209,50,23,23,23,23,23,23,23,23,23,23,23,23,23,23,23,23,23
106,23,23,23,23,23,23,23,23,23,23,23,23,23,50,2,2,2,2,2,2,2,4,5,2,2,2,2,2,2,2,219,50,23,23,23,23,23,23,23,23,23,23,23,23,23,23,23,23,23
106,23,23,23,23,23,23,23,23,23,23,23,23,23,50,2,2,4,5,2,2,2,2,2,2,2,2,2,2,4,5,2,50,23,23,23,23,23,23,23,23,23,23,23,23,23,23,23,23,23
106,23,23,23,23,23,23,23,23,23,23,23,23,23,50,2,2,2,2,2,2,2,2,2,2,112,4,5,2,4,5,2,50,23,23,23,23,23,23,23,23,23,23,23,23,23,23,23,23,23
106,57,51,51,51,51,51,51,51,51,51,51,51,51,60,2,2,2,2,2,2,2,2,2,2,2,2,2,2,2,2,2,61,51,51,51,51,51,51,51,51,51,51,51,51,51,51,67,23,23
106,50,2,2,4,5,2,2,2,2,2,2,2,2,2,2,2,2,4,187,5,2,2,4,5,2,2,2,2,4,5,2,2,2,2,2,2,2,2,2,2,2,2,2,2,2,2,50,23,23
106,50,2,2,2,2,2,57,51,51,51,51,51,51,67,2,2,226,2,197,2,2,2,2,2,2,2,2,2,2,2,2,57,51,51,51,51,51,51,51,67,200,4,5,2,2,2,50,23,23
106,50,2,2,4,5,2,50,23,23,23,23,23,23,50,2,199,2,112,2,2,2,2,2,2,2,2,2,2,2,2,2,50,23,23,23,23,23,23,23,50,210,4,5,2,4,5,50,23,23
106,50,2,112,4,5,2,50,23,23,23,23,23,23,61,51,51,51,51,51,51,51,51,51,51,51,51,51,51,51,51,51,60,23,23,23,23,23,23,23,50,2,2,4,5,209,209,50,23,23
106,50,203,5,5,2,2,50,23,23,23,23,23,23,23,23,23,23,23,23,23,23,23,23,23,23,23,23,23,23,23,23,23,23,23,23,23,23,23,23,50,2,2,4,209,219,219,50,23,23
106,50,213,2,2,2,2,50,23,23,23,23,23,23,23,23,23,23,23,23,23,23,23,23,23,23,23,23,23,23,23,23,23,23,23,23,23,23,23,23,50,2,2,2,219,112,228,50,23,23
106,61,51,51,51,51,51,60,23,23,23,23,23,23,23,23,23,23,23,23,23,23,23,23,23,23,23,23,23,23,23,23,23,23,23,23,23,23,23,23,61,51,51,51,51,51,51,60,23,23
